111111111111
1000N0000E11
1100C0000001
1000000C0001
100000000001
1N0000000011
111111111111